1111111111
1P000000C1
1111111001
1E00000001
1111111111