1111111111
100000P0C1
1111111001
1E00000001
1111111111