1111111
1P000C1
1111101
1E00001
1111111