1111111111111111111
1000000000000000001
1000000000000000001
1010001000000010001
1000000000000000001
100000C00C00C000001
10000P0000C00010001
1C00000000E00000001
1111111111111111111