1111111111111111111
100000000C000000001
1111111111111111111
1010001000000010001
1000000000000000001
10000CCCCCC000E0001
10000P0000000010001
1000000000000000001
1111111111111111111