111111111111111111111111111111
1P000000000000000000000000CC01
1110000000011111E0000000000111
111111111111111111111111111111