1111111111111111111
1000C0000C00000C001
100CC0C000000000001
1010101000000010001
1000000000000000001
100C00C00C00C000001
1000P00000C00010001
1C00000000E00000001
1111111111111111111