11111111111111111111
10P00C00000C00000001
10000C000000000000C1
10001110011100000001
10001C1001C1C0000001
1000101CC10101111111
10001011110100000001
10001010000111111101
10001010000100000001
10001010000101111111
100000000001000000E1
11111111111111111111